F7F7F7
|LJLJ|
L--7||
F7FJLJ
|LJF7F
L--JLJ

0 0 0 2 0 0
0 0 0 0 0 0
0 2 0 0 0 3
0 0 0 0 0 0
0 0 0 0 0 0
0 0 0 0 0 0
